WWWWWWWWWWWWWWWWWWWWWWWWWWWWWWWWWWWWWWWW            
WCSW     W                             W
W  W  W  W                             W
W     W  WWWWWWW                       W
WWWWWWW  W   WCW                       W
WCCCWC   W W   W                       W
W   E      W                           W
WWWWWWWWWWWWWW                         W
W                                      W
W                                      W
W                                      W
W                                      W
W                                      W
W                                      W
W                                      W
W                                      W
W                                      W
W                                      W
W                                      W
W                                      W
W                                      W
W                                      W
W                                      W
W                                      W
W                                      W
W                                      W
W                                      W
W                                      W
W                                      W
WWWWWWWWWWWWWWWWWWWWWWWWWWWWWWWWWWWWWWWW

